亚洲:
中国	中华人民共和国	北京	上海/深圳/广州/南京/杭州/成都/西安/天津/重庆/武汉
蒙古	蒙古国	乌兰巴托
朝鲜	朝鲜民主主义人民共和国	平壤
韩国	大韩民国	首尔	釜山/大邱/仁川/光州/济州岛
日本	日本国	东京	大阪/京都/横滨/神户/福冈/札幌/仙台/广岛/冲绳
越南	越南社会主义共和国	河内	胡志明市/西贡
老挝	老挝人民民主共和国	万象
柬埔寨	柬埔寨王国	金边
缅甸	缅甸联邦	仰光
泰国	泰王国	曼谷	清迈/清莱/普吉岛/芭提雅
马来西亚	马来西亚	吉隆坡
新加坡	新加坡共和国	新加坡
文莱	文莱达鲁萨兰国	斯里巴加湾市
菲律宾	菲律宾共和国	马尼拉
印度尼西亚	印度尼西亚共和国	雅加达
东帝汶	东帝汶民主共和国	帝力
尼泊尔	尼泊尔联邦民主共和国	加德满都
不丹	不丹王国	廷布
孟加拉国	孟加拉人民共和国	达卡
印度	印度共和国	新德里	孟买/加尔各答/金奈/班加罗尔/海得拉巴/昌迪加尔
斯里兰卡	斯里兰卡民主社会主义共和国	科伦坡
马尔代夫	马尔代夫共和国	马累
巴基斯坦	巴基斯坦伊斯兰共和国	伊斯兰堡	卡拉奇/拉合尔
阿富汗	阿富汗伊斯兰国	喀布尔
伊朗	伊朗伊斯兰共和国	德黑兰
科威特	科威特国	科威特城
沙特	沙特阿拉伯王国	利雅得
巴林	巴林国	麦纳麦
卡塔尔	卡塔尔国	多哈
阿联酋	阿拉伯联合酋长国	阿布扎比	迪拜
阿曼	阿曼苏丹国	马斯喀特
也门	也门共和国	萨那
伊拉克	伊拉克共和国	巴格达
叙利亚	阿拉伯叙利亚共和国	大马士革
黎巴嫩	黎巴嫩共和国	贝鲁特
约旦	约旦哈希姆王国	安曼
巴勒斯坦	巴勒斯坦国	拉马拉
以色列	以色列国	特拉维夫
塞浦路斯	塞浦路斯共和国	尼科西亚
土耳其	土耳其共和国	安卡拉	伊斯坦布尔
乌兹别克斯坦	乌兹别克斯坦共和国	塔什干
哈萨克斯坦	哈萨克斯坦共和国	阿斯塔纳	阿拉木图
吉尔吉斯斯坦	吉尔吉斯共和国	比什凯克
塔吉克斯坦	塔吉克斯坦共和国	杜尚别
亚美尼亚	亚美尼亚共和国	埃里温
土库曼斯坦	土库曼斯坦	阿什哈巴德
阿塞拜疆	阿塞拜疆共和国	巴库
格鲁吉亚	格鲁吉亚	第比利斯
欧洲:
冰岛	冰岛共和国	雷克雅未克
丹麦	丹麦王国	哥本哈根
挪威	挪威王国	奥斯陆
瑞典	瑞典王国	斯德哥尔摩
芬兰	芬兰共和国	赫尔辛基
俄罗斯	俄罗斯联邦	莫斯科	圣彼得堡/符拉迪沃斯托克/海参崴/叶卡捷琳堡/下诺夫哥罗德/加里宁格勒
乌克兰	乌克兰	基辅	斯拉维扬斯克
白俄罗斯	白俄罗斯共和国	明斯克
摩尔多瓦	摩尔多瓦共和国	基希讷乌
立陶宛	立陶宛共和国	维尔纽斯
爱沙尼亚	爱沙尼亚共和国	塔林
拉脱维亚	拉脱维亚共和国	里加
波兰	波兰共和国	华沙
捷克	捷克共和国	布拉格
匈牙利	匈牙利共和国	布达佩斯
德国	德意志联邦共和国	柏林	法兰克福/慕尼黑/汉堡/科隆/斯图加特
奥地利	奥地利共和国	维也纳
列支敦士登	列支敦士登公国	瓦杜兹
瑞士	瑞士联邦	伯尔尼	苏黎世/日内瓦
荷兰	荷兰王国	阿姆斯特丹	鹿特丹
比利时	比利时王国	布鲁塞尔
卢森堡	卢森堡大公国	卢森堡
英国	大不列颠及北爱尔兰联合王国	伦敦	曼彻斯特/爱丁堡/伯明翰/利兹/格拉斯哥/谢菲尔德/利物浦/布里斯托尔
爱尔兰	爱尔兰共和国	都柏林
法国	法兰西共和国	巴黎	马赛/里昂/图卢兹/斯特拉斯堡
摩纳哥	摩纳哥公国	摩纳哥
安道尔	安道尔公国	安道尔
西班牙	西班牙	马德里	巴塞罗那/巴伦西亚/塞维利亚/马拉加/毕尔巴鄂/萨拉戈萨
葡萄牙	葡萄牙共和国	里斯本
意大利	意大利共和国	罗马	米兰/佛罗伦萨/都灵/那不勒斯/巴勒莫/热那亚/佛罗伦萨/威尼斯
梵蒂冈	梵蒂冈城国	梵蒂冈城
圣马力诺	圣马力诺共和国	圣马力诺
马耳他	马耳他共和国	瓦莱塔
克罗地亚	克罗地亚共和国	萨格勒布
斯洛伐克	斯洛伐克共和国	布拉迪斯拉发
斯洛文尼亚	斯洛文尼亚共和国	卢布尔雅那
波黑	波斯尼亚和黑塞哥维那共和国	萨拉热窝
马其顿	马其顿共和国	斯科普里
塞尔维亚	塞尔维亚共和国	贝尔格莱德
黑山	黑山共和国	波德戈里察
科索沃	科索沃国	普里什蒂纳
罗马尼亚	罗马尼亚	布加勒斯特
保加利亚	保加利亚共和国	索非亚
阿尔巴尼亚	阿尔巴尼亚共和国	地拉那
希腊	希腊共和国	雅典
非洲:
埃及	阿拉伯埃及共和国	开罗	亚历山大/伊斯梅利亚/塞得港/沙姆沙伊赫/卢克索/阿斯旺
利比亚	大阿拉伯利比亚人民社会主义民众国	的黎波里
突尼斯	突尼斯共和国	突尼斯
阿尔及利亚	阿尔及利亚民主人民共和国	阿尔及尔
摩洛哥	摩洛哥王国	拉巴特	卡萨布兰卡/达尔贝达
毛里塔尼亚	毛里塔尼亚伊斯兰共和国	努瓦克肖特
塞内加尔	塞内加尔共和国	达喀尔
冈比亚	冈比亚共和国	班珠尔
马里	马里共和国	巴马科
布基纳法索	布基纳法索	瓦加杜古
佛得角	佛得角共和国	普拉亚
几内亚比绍	几内亚比绍共和国	比绍
几内亚	几内亚共和国	科纳克里
塞拉里昂	塞拉里昂共和国	弗里敦
利比里亚	利比里亚共和国	蒙罗维亚
科特迪瓦	科特迪瓦共和国	亚穆苏克罗
加纳	加纳共和国	阿克拉
多哥	多哥共和国	洛美
贝宁	贝宁共和国	波多诺伏
尼日尔	尼日尔共和国	尼亚美
尼日利亚	尼日利亚联邦共和国	阿布贾
喀麦隆	喀麦隆共和国	雅温得
赤道几内亚	赤道几内亚共和国	马拉博
乍得	乍得共和国	恩贾梅纳
中非	中非共和国	班吉
苏丹	苏丹共和国	喀土穆
南苏丹	南苏丹共和国	朱巴
埃塞俄比亚	埃塞俄比亚联邦民主共和国	亚的斯亚贝巴
吉布提	吉布提共和国	吉布提
索马里	索马里共和国	摩加迪沙
肯尼亚	肯尼亚共和国	内罗毕
乌干达	乌干达共和国	坎帕拉
坦桑尼亚	坦桑尼亚联合共和国	达累斯萨拉姆
卢旺达	卢旺达共和国	基加利
布隆迪	布隆迪共和国	布琼布拉
刚果(金)	刚果民主共和国	金沙萨
刚果(布)	刚果共和国	布拉柴维尔
加蓬	加蓬共和国	利伯维尔
圣多美和普林西比	圣多美和普林西比民主共和国	圣多美
安哥拉	安哥拉共和国	罗安达
赞比亚	赞比亚共和国	卢萨卡
马拉维	马拉维共和国	利隆圭
莫桑比克	莫桑比克共和国	马普托
科摩罗	科摩罗伊斯兰联邦共和国	莫罗尼
马达加斯加	马达加斯加共和国	塔那那利佛
塞舌尔	塞舌尔共和国	维多利亚
毛里求斯	毛里求斯共和国	路易斯港
津巴布韦	津巴布韦共和国	哈拉雷
博茨瓦纳	博茨瓦纳共和国	哈博罗内
纳米比亚	纳米比亚共和国	温得和克
南非	南非共和国	比勒陀利亚	开普敦/好望角/约翰内斯堡/德班/伊丽莎白港
斯威士兰	斯威士兰王国	姆巴巴纳
莱索托	莱索托王国	马塞卢
厄立特里亚	厄立特里亚国	阿斯马拉
大洋州:
澳大利亚	澳大利亚联邦	堪培拉	悉尼/墨尔本/布里斯班/珀斯
新西兰	新西兰	惠灵顿	奥克兰
巴布亚新几内亚	巴布亚新几内亚独立国	莫尔兹比港	巴新
所罗门群岛	所罗门群岛	霍尼亚拉
瓦努阿图	瓦努阿图共和国	维拉港
斐济	斐济群岛共和国	苏瓦
基里巴斯	基里巴斯共和国	塔拉瓦
瑙鲁	瑙鲁共和国	亚伦
密克罗尼西亚	密克罗尼西亚联邦	帕利基尔
马绍尔群岛	马绍尔群岛共和国	马朱罗
图瓦卢	图瓦卢	富纳富提
萨摩亚	萨摩亚独立国	阿皮亚
纽埃	纽埃	阿洛菲
帕劳	帕劳共和国	科罗尔
汤加	汤加王国	努库阿洛法
北美洲:
加拿大	加拿大	渥太华	温哥华/多伦多/蒙特利尔
美国	美利坚合众国	华盛顿	纽约/芝加哥/底特律/洛杉矶/旧金山/休斯顿/费城/西雅图/波士顿/匹兹堡/盐湖城/亚特兰大
墨西哥	墨西哥合众国	墨西哥城
危地马拉	危地马拉共和国	危地马拉
伯利兹	伯利兹	贝尔莫潘
萨尔瓦多	萨尔瓦多共和国	圣萨尔瓦多
洪都拉斯	洪都拉斯共和国	特古西加尔巴
尼加拉瓜	尼加拉瓜共和国	马那瓜
哥斯达黎加	哥斯达黎加共和国	圣何塞
巴拿马	巴拿马共和国	巴拿马城
巴哈马	巴哈马国	拿骚
古巴	古巴共和国	哈瓦那
牙买加	牙买加	金斯敦
海地	海地共和国	太子港
多米尼加	多米尼加共和国	圣多明各
圣基茨和尼维斯	圣基茨和尼维斯联邦	巴斯特尔
安提瓜和巴布达	安提瓜和巴布达	圣约翰
多米尼克国	多米尼克国	罗索
圣卢西亚	圣卢西亚	卡斯特里
圣文森特和格林纳丁斯	圣文森特和格林纳丁斯	金斯敦
巴巴多斯	巴巴多斯	布里奇顿
格林纳达	格林纳达	圣乔治
特立尼达和多巴哥	特立尼达和多巴哥共和国	西班牙港
南美洲:
哥伦比亚	哥伦比亚共和国	波哥大
委内瑞拉	委内瑞拉玻利瓦尔共和国	加拉加斯
圭亚那	圭亚那合作共和国	乔治敦
苏里南	苏里南共和国	帕拉马里博
厄瓜多尔	厄瓜多尔共和国	基多
秘鲁	秘鲁共和国	利马
巴西	巴西联邦共和国	巴西利亚	圣保罗/里约热内卢/累西腓
玻利维亚	多民族玻利维亚国	拉巴斯
智利	智利共和国	圣地亚哥
阿根廷	阿根廷共和国	布宜诺斯艾利斯	乌斯怀亚
巴拉圭	巴拉圭共和国	亚松森
乌拉圭	乌拉圭东岸共和国	蒙得维的亚
